关系|guānxi|quan hệ|良好的家庭关系对健康很重要。|Liánghǎo de jiātíng guānxì duì jiànkāng hěn zhòngyào.|Mối quan hệ gia đình tốt rất quan trọng đối với sức khỏe.
瓶子|píngzi|cái chai,lọ, bình|这种药在瓶子里。|Zhè zhǒng yào zài píngzi lǐ.|Loại thuốc này ở trong chai.
体育|tǐyù|thể dục|他每天都做体育锻炼。|Tā měitiān dōu zuò tǐyù duànliàn.|Anh ấy tập thể dục hàng ngày.
脸色|liǎnsè|sắc mặt|他的脸色看起来不太好。|Tā de liǎnsè kàn qǐlái bù tài hǎo.|Sắc mặt của anh ấy trông không tốt lắm.
康复|kāngfù|bình phục, khỏe lại|祝你早日康复。|Zhù nǐ zǎorì kāngfù.|Chúc bạn sớm hồi phục.
借口|jièkǒu|cái cớ|不要找借口不去锻炼。|Bùyào zhǎo jièkǒu bù qù duànliàn.|Đừng tìm cớ để không đi tập thể dục.
健康|jiànkāng|sức khỏe, khỏe mạnh, lành mạnh|保持健康是最大的财富。|Bǎochí jiànkāng shì zuìdà de cáifù.|Giữ gìn sức khỏe là tài sản lớn nhất.
饮食|yǐnshí|ẩm thực, ăn uống|他的饮食很健康。|Tā de yǐnshí hěn jiànkāng.|Chế độ ăn uống của anh ấy rất lành mạnh.
甜品|tiánpǐn|đồ ngọt|我喜欢饭后吃点甜品。|Wǒ xǐhuān fàn hòu chī diǎn tiánpǐn.|Tôi thích ăn một chút đồ ngọt sau bữa ăn.
压力|yālì|áp lực|学习压力太大，他失眠了。|Xuéxí yālì tài dà, tā shīmiánle.|Áp lực học tập quá lớn, anh ấy bị mất ngủ.
轻音乐|qīng yīnyuè|nhạc nhẹ, nhạc không lời|听轻音乐可以放松心情。|Tīng qīng yīnyuè kěyǐ fàngsōng xīnqíng.|Nghe nhạc nhẹ có thể thư giãn tâm trạng.
效果|xiàoguǒ|hiệu quả|这种药的效果很好。|Zhè zhǒng yào de xiàoguǒ hěn hǎo.|Hiệu quả của loại thuốc này rất tốt.
作息|zuòxī|làm việc và nghỉ ngơi|他作息时间很不规律。|Tā zuòxī shíjiān hěn bù guīlǜ.|Giờ giấc sinh hoạt của anh ấy không có quy luật.
心情|xīnqíng|tâm trạng|他的心情今天很好。|Tā de xīnqíng jīntiān hěn hǎo.|Tâm trạng của anh ấy hôm nay rất tốt.
味道|wèidào|mùi vị|这个汤的味道很淡。|Zhège tāng de wèidào hěn dàn.|Vị của món canh này rất nhạt.
果汁|guǒzhī|nước ép trái cây|每天一杯新鲜的果汁对身体有益。|Měitiān yībēi xīnxiān de guǒzhī duì shēntǐ yǒuyì.|Mỗi ngày một cốc nước ép trái cây tươi có lợi cho cơ thể.
生活|shēnghuó|cuộc sống, đời sống, sinh hoạt|他过着健康的生活。|Tā guòzhe jiànkāng de shēnghuó.|Anh ấy sống một cuộc sống lành mạnh.
草地|cǎodì|bãi cỏ|我们在草地上做瑜伽。|Wǒmen zài cǎodì shàng zuò yújiā.|Chúng tôi tập yoga trên bãi cỏ.
维生素|wéishēngsù|vitamin|多吃蔬菜补充维生素。|Duō chī shūcài bǔchōng wéishēngsù.|Ăn nhiều rau để bổ sung vitamin.
纤维|xiānwéi|chất xơ|吃苹果可以补充纤维。|Chī píngguǒ kěyǐ bǔchōng xiānwéi.|Ăn táo có thể bổ sung chất xơ.
力气|lìqi|sức, sức lực|我没有力气了。|Wǒ méiyǒu lìqi le.|Tôi không còn sức lực nữa.
牙科|yákē|Nha khoa|我要去牙科看牙。|Wǒ yào qù yákē kàn yá.|Tôi phải đến nha khoa khám răng.
难怪|nánguài|chẳng trách, hèn chi|难怪你脸色不好，原来你熬夜了。|Nánguài nǐ liǎnsè bù hǎo, yuánlái nǐ áoyèle.|Hèn chi sắc mặt cậu không tốt, hóa ra là cậu thức khuya.
眼泪|yǎnlèi|nước mắt|她流着眼泪。|Tā liúzhe yǎnlèi.|Cô ấy đang rơi nước mắt.
泪水|lèishuǐ|nước mắt|他的泪水止不住地流。|Tā de lèishuǐ zhǐ bù zhù de liú.|Nước mắt của anh ấy không ngừng rơi.
体检|tǐjiǎn|khám sức khỏe|我们公司每年都安排体检。|Wǒmen gōngsī měinián dōu ānpái tǐjiǎn.|Công ty chúng tôi hàng năm đều sắp xếp khám sức khỏe.
状况|zhuàngkuàng|tình trạng|他的健康状况不太好。|Tā de jiànkāng zhuàngkuàng bù tài hǎo.|Tình trạng sức khỏe của anh ấy không tốt lắm.
腰|yāo|eo, thắt lưng|我腰疼。|Wǒ yāo téng.|Tôi bị đau lưng.
肚子|dùzi|bụng|我肚子疼。|Wǒ dùzi téng.|Tôi bị đau bụng.
胃脏|wèizàng|dạ dày|胃脏不好要少吃辛辣食物。|Wèizàng bù hǎo yào shǎo chī xīnlà shíwù.|Dạ dày không tốt thì nên ăn ít đồ cay nóng.
肝脏|gānzàng|gan|保护肝脏，少喝酒。|Bǎohù gānzàng, shǎo hējiǔ.|Bảo vệ gan, uống ít rượu.
肺脏|fèizàng|phổi|吸烟对肺脏有伤害。|Xīyān duì fèizàng yǒu shānghài.|Hút thuốc có hại cho phổi.
心脏|xīnzàng|tim|心脏是人体最重要的器官。|Xīnzàng shì réntǐ zuì zhòngyào de qìguān.|Tim là cơ quan quan trọng nhất của cơ thể.
肾脏|shènzàng|thận|多喝水对肾脏好。|Duō hē shuǐ duì shènzàng hǎo.|Uống nhiều nước tốt cho thận.
汗|hàn|mồ hôi|锻炼后，我出了一身汗。|Duànliàn hòu, wǒ chūle yīshēn hàn.|Sau khi tập thể dục, tôi đổ mồ hôi toàn thân.
皮肤|pífū|da, làn da|他的皮肤很白。|Tā de pífū hěn bái.|Da của anh ấy rất trắng.
秘诀|mìjué|bí quyết|保持健康的秘诀是什么？|Bǎochí jiànkāng de mìjué shì shénme?|Bí quyết giữ gìn sức khỏe là gì?
洗面奶|xǐmiànnǎi|sữa rửa mặt|每天用洗面奶洗脸。|Měitiān yòng xǐmiànnǎi xǐ liǎn.|Hàng ngày dùng sữa rửa mặt để rửa mặt.
面膜|miànmó|mặt nạ|敷面膜可以补水。|Fū miànmó kěyǐ bǔ shuǐ.|Đắp mặt nạ có thể cấp nước.
瑜伽|yújiā|yoga|练瑜伽对身体和心理都有好处。|Liàn yújiā duì shēntǐ hé xīnlǐ dōu yǒu hǎochù.|Tập yoga có lợi cho cả thể chất và tinh thần.
抑郁|yìyù|trầm cảm|她得了抑郁症。|Tā déliǎo yìyùzhèng.|Cô ấy bị trầm cảm.
心理|xīnlǐ|tâm lý|保持积极的心理很重要。|Bǎochí jījí de xīnlǐ hěn zhòngyào.|Giữ tâm lý tích cực rất quan trọng.
能量|néngliàng|năng lượng|早餐是一天能量的来源。|Zǎocān shì yītiān néngliàng de láiyuán.|Bữa sáng là nguồn năng lượng của cả ngày.
生命|shēngmìng|sinh mệnh, sự sống|生命只有一次，要好好珍惜。|Shēngmìng zhǐyǒu yīcì, yào hǎohǎo zhēnxī.|Cuộc sống chỉ có một lần, phải biết trân trọng.
源|yuán|nguồn|运动是活力的源泉。|Yùndòng shì huólì de yuánquán.|Vận động là suối nguồn của sự sống.
毒素|dúsù|độc tố|排出身体里的毒素。|Páichū shēntǐ lǐ de dúsù.|Đào thải độc tố trong cơ thể.
水分|shuǐfèn|nước, lượng nước|补充足够的水分。|Bǔchōng zúgòu de shuǐfèn.|Bổ sung đủ lượng nước.
预防|yùfáng|phòng ngừa|预防疾病比治疗更重要。|Yùfáng jíbìng bǐ zhìliáo gèng zhòngyào.|Phòng bệnh quan trọng hơn chữa bệnh.
疾病|jíbìng|bệnh tật|养成好习惯可以预防很多疾病。|Yǎngchéng hǎo xíguàn kěyǐ yùfáng hěn duō jíbìng.|Hình thành thói quen tốt có thể phòng ngừa nhiều bệnh.
活力|huólì|sức sống|运动让人充满活力。|Yùndòng ràng rén chōngmǎn huólì.|Vận động giúp con người tràn đầy sức sống.
烟|yān|thuốc lá|戒烟对健康有好处。|Jièyān duì jiànkāng yǒu hǎochù.|Cai thuốc có lợi cho sức khỏe.
睡眠|shuìmián|giấc ngủ|保证充足的睡眠很重要。|Bǎozhèng chōngzú de shuìmián hěn zhòngyào.|Đảm bảo ngủ đủ giấc rất quan trọng.
次数|cìshù|số lần|你一天锻炼几次？|Nǐ yītiān duànliàn jǐ cì?|Bạn tập thể dục mấy lần một ngày?
习惯|xíguàn|thói quen|养成早睡早起的好习惯。|Yǎngchéng zǎo shuì zǎoqǐ de hǎo xíguàn.|Hình thành thói quen tốt là ngủ sớm dậy sớm.
担心|dānxīn|lo lắng|别担心，你会康复的。|Bié dānxīn, nǐ huì kāngfù de.|Đừng lo, bạn sẽ hồi phục thôi.
锻炼|duànliàn|rèn luyện|每天锻炼身体。|Měitiān duànliàn shēntǐ.|Mỗi ngày tập thể dục.
关心|guānxīn|quan tâm|她很关心我的健康。|Tā hěn guānxīn wǒ de jiànkāng.|Cô ấy rất quan tâm đến sức khỏe của tôi.
难过|nánguò|buồn bã, đau lòng|考试没考好，我很难过。|Kǎoshì méi kǎo hǎo, wǒ hěn nánguò.|Thi không tốt, tôi rất buồn.
打针|dǎzhēn|tiêm thuốc|他很害怕打针。|Tā hěn hàipà dǎzhēn.|Anh ấy rất sợ tiêm thuốc.
坚持|jiānchí|kiên trì|坚持锻炼，你会有好身体。|Jiānchí duànliàn, nǐ huì yǒu hǎo shēntǐ.|Kiên trì tập thể dục, bạn sẽ có một cơ thể khỏe mạnh.
得|dé|phải|他得了重感冒。|Tā déliǎo zhòng gǎnmào.|Anh ấy bị cảm nặng.
着|zháo|trợ từ|睡着了。|Shuìzháo le.|Ngủ rồi.
闭|bì|nhắm, đóng|闭上眼睛好好休息。|Bì shàng yǎnjīng hǎohǎo xiūxí.|Nhắm mắt lại và nghỉ ngơi thật tốt.
睡不着|shuì bù zháo|ngủ không được|我晚上睡不着。|Wǒ wǎnshàng shuì bù zháo.|Tối tôi không ngủ được.
熬夜|áoyè|thức khuya|熬夜对身体不好。|Áoyè duì shēntǐ bù hǎo.|Thức khuya không tốt cho sức khỏe.
注意|zhùyì|chú ý|注意身体，别太累了。|Zhùyì shēntǐ, bié tài lèi le.|Chú ý sức khỏe, đừng quá mệt mỏi.
提醒|tíxǐng|nhắc nhở|医生提醒我要按时吃药。|Yīshēng tíxǐng wǒ yào ànshí chī yào.|Bác sĩ nhắc nhở tôi phải uống thuốc đúng giờ.
放松|fàngsōng|thư giãn, thả lỏng, buông lỏng|放松心情，不要太紧张。|Fàngsōng xīnqíng, bùyào tài jǐnzhāng.|Thư giãn tâm trạng, đừng quá căng thẳng.
重视|zhòngshì|coi trọng|我们应该重视自己的健康。|Wǒmen yīnggāi zhòngshì zìjǐ de jiànkāng.|Chúng ta nên coi trọng sức khỏe của bản thân.
调整|tiáozhěng|điều chỉnh|调整作息时间。|Tiáozhěng zuòxī shíjiān.|Điều chỉnh giờ giấc sinh hoạt.
相信|xiāngxìn|tin,tin tưởng,tin rằng|相信自己，你可以做到。|Xiāngxìn zìjǐ, nǐ kěyǐ zuòdào.|Tin tưởng vào bản thân, bạn có thể làm được.
补充|bǔchōng|bổ sung|补充营养和水分。|Bǔchōng yíngyǎng hé shuǐfèn.|Bổ sung dinh dưỡng và nước.
缺少|quēshǎo|thiếu|他缺少维生素C。|Tā quēshǎo wéishēngsù C.|Anh ấy thiếu vitamin C.
捂|wǔ|che, bịt|捂着肚子。|Wǔzhe dùzi.|Ôm bụng.
疼|téng|đau|我的头很疼。|Wǒ de tóu hěn téng.|Đầu tôi rất đau.
止痛|zhǐtòng|giảm đau|这种药可以止痛。|Zhè zhǒng yào kěyǐ zhǐtòng.|Loại thuốc này có thể giảm đau.
保护|bǎohù|bảo vệ|保护眼睛，少看手机。|Bǎohù yǎnjīng, shǎo kàn shǒujī.|Bảo vệ mắt, ít xem điện thoại di động.
负责|fùzé|chịu trách nhiệm|我们要对自己的健康负责。|Wǒmen yào duì zìjǐ de jiànkāng fùzé.|Chúng ta phải chịu trách nhiệm về sức khỏe của chính mình.
按时|ànshí|đúng giờ|按时吃饭、睡觉。|Ànshí chīfàn, shuìjiào.|Ăn cơm, ngủ đúng giờ.
减肥|jiǎnféi|giảm cân|她正在努力减肥。|Tā zhèngzài nǔlì jiǎnféi.|Cô ấy đang cố gắng giảm cân.
控制|kòngzhì|kiểm soát, khống chế, điều khiển|控制体重对健康很重要。|Kòngzhì tǐzhòng duì jiànkāng hěn zhòngyào.|Kiểm soát cân nặng rất quan trọng đối với sức khỏe.
敷|fū|đắp, thoa|敷面膜。|Fū miànmó.|Đắp mặt nạ.
鼓励|gǔlì|khuyến khích, khích lệ, cổ vũ|医生鼓励他多运动。|Yīshēng gǔlì tā duō yùndòng.|Bác sĩ khuyến khích anh ấy tập thể dục nhiều hơn.
恢复|huīfù|khôi phục|他很快就恢复了健康。|Tā hěn kuài jiù huīfùle jiànkāng.|Anh ấy đã sớm phục hồi sức khỏe.
排除|páichú|loại bỏ|排除体内的毒素。|Páichú tǐnèi de dúsù.|Đào thải độc tố trong cơ thể.
保持|bǎochí|giữ, duy trì|保持一个积极的心态。|Bǎochí yīgè jījí de xīntài.|Duy trì một thái độ tích cực.
戒|jiè|cai|戒烟、戒酒。|Jièyān, jièjiǔ.|Cai thuốc, cai rượu.
减少|jiǎnshǎo|giảm bớt|减少糖分摄入。|Jiǎnshǎo tángfèn shè rù.|Giảm lượng đường nạp vào.
增加|zēngjiā|tăng thêm|增加运动量。|Zēngjiā yùndòng liàng.|Tăng lượng vận động.
伤害|shānghài|làm tổn thương|酒精会伤害肝脏。|Jiǔjīng huì shānghài gānzàng.|Cồn sẽ làm hại gan.
治疗|zhìliáo|chữa bệnh, điều trị|接受治疗。|Jiēshòu zhìliáo.|Chấp nhận điều trị.
习惯|xíguàn|quen|我已经习惯了早睡早起。|Wǒ yǐjīng xíguànle zǎo shuì zǎoqǐ.|Tôi đã quen với việc ngủ sớm dậy sớm.
失眠|shīmián|mất ngủ|他最近失眠很严重。|Tā zuìjìn shīmián hěn yánzhòng.|Gần đây anh ấy bị mất ngủ rất nghiêm trọng.
冒|mào|toát ra, bốc lên|我冒了一身冷汗。|Wǒ màole yīshēn lěnghàn.|Tôi toát mồ hôi lạnh toàn thân.
几乎|jīhū|gần như|我几乎每天都去跑步。|Wǒ jīhū měitiān dōu qù pǎobù.|Tôi gần như ngày nào cũng đi chạy bộ.
努力|nǔlì|nỗ lực|努力工作，也要注意休息。|Nǔlì gōngzuò, yěyào zhùyì xiūxí.|Cố gắng làm việc, cũng phải chú ý nghỉ ngơi.
其实|qíshí|thật ra|其实他的身体状况很好。|Qíshí tā de shēntǐ zhuàngkuàng hěn hǎo.|Thật ra tình trạng sức khỏe của anh ấy rất tốt.
实在|shízài|thật sự, quả thực|我实在太累了。|Wǒ shízài tài lèile.|Tôi thực sự quá mệt rồi.
奇怪|qíguài|kỳ lạ|感觉有点奇怪。|Gǎnjué yǒudiǎn qíguài.|Cảm thấy hơi kỳ lạ.
清淡|qīngdàn|thanh đạm|饮食清淡对身体好。|Yǐnshí qīngdàn duì shēntǐ hǎo.|Ăn uống thanh đạm tốt cho cơ thể.
改变|gǎibiàn|thay đổi|改变你的生活习惯。|Gǎibiàn nǐ de shēnghuó xíguàn.|Thay đổi thói quen sinh hoạt của bạn.
没有用|méiyǒu yòng|không tác dụng|这个方法没有用。|Zhège fāngfǎ méiyǒu yòng.|Phương pháp này không có tác dụng.
规律|guīlǜ|quy luật, điều độ|规律的作息时间很重要。|Guīlǜ de zuòxī shíjiān hěn zhòngyào.|Giờ giấc sinh hoạt có quy luật rất quan trọng.
严重|yánzhòng|nghiêm trọng|他的病情很严重。|Tā de bìngqíng hěn yánzhòng.|Bệnh tình của anh ấy rất nghiêm trọng.
难受|nánshòu|khó chịu|我感觉很难受。|Wǒ gǎnjué hěn nánshòu.|Tôi cảm thấy rất khó chịu.
当然|dāngrán|đương nhiên|当然，健康是第一位的。|Dāngrán, jiànkāng shì dì yī wèi de.|Đương nhiên, sức khỏe là ưu tiên số một.
过度|guòdù|quá độ, quá mức|过度疲劳对身体不好。|Guòdù píláo duì shēntǐ bù hǎo.|Mệt mỏi quá độ không tốt cho cơ thể.
疲劳|píláo|mệt mỏi|他感到很疲劳。|Tā gǎndào hěn píláo.|Anh ấy cảm thấy rất mệt mỏi.
干|gān|khô|皮肤很干。|Pífū hěn gān.|Da rất khô.
湿|shī|ướt|身体湿气太重。|Shēntǐ shīqì tài zhòng.|Khí ẩm trong cơ thể quá nặng.
好好|hǎohāo||好好休息。|Hǎohāo xiūxí.|Nghỉ ngơi thật tốt.
常见|chángjiàn|thường gặp|这是一个常见的健康问题。|Zhè shì yīgè chángjiàn de jiànkāng wèntí.|Đây là một vấn đề sức khỏe thường gặp.
定期|dìngqī|định kỳ|定期体检。|Dìngqī tǐjiǎn.|Khám sức khỏe định kỳ.
苍白|cāngbái|tái nhợt, nhợt nhạt|他的脸色苍白。|Tā de liǎnsè cāngbái.|Sắc mặt của anh ấy trắng bệch.
懒|lǎn|lười|你太懒了，要多运动。|Nǐ tài lǎnle, yào duō yùndòng.|Cậu lười quá, phải tập thể dục nhiều hơn.
勤奋|qínfèn|cần cù, siêng năng|勤奋的人会更健康。|Qínfèn de rén huì gèng jiànkāng.|Người chăm chỉ sẽ khỏe mạnh hơn.
值得|zhídé|đáng giá, đáng để, đáng|保持健康值得你付出努力。|Bǎochí jiànkāng zhídé nǐ fùchū nǔlì.|Giữ gìn sức khỏe đáng để bạn nỗ lực.
直接|zhíjiē|trực tiếp|直接说出你的感受。|Zhíjiē shuō chū nǐ de gǎnshòu.|Nói thẳng cảm nhận của bạn.
着急|zháojí|sốt ruột, nóng vội, vội vàng, |不要着急，慢慢来。|Bùyào zháojí, màn man lái.|Đừng lo lắng, từ từ thôi.
害|hài|hại, có hại, làm hại|害得我晚上睡不着。|Hàidé wǒ wǎnshàng shuì bù zháo.|Khiến tôi buổi tối không ngủ được.
傍晚|bàngwǎn|xế chiều, chập tối, chiều tối|我傍晚去公园跑步。|Wǒ bàngwǎn qù gōngyuán pǎobù.|Tôi đi chạy bộ ở công viên vào xế chiều.
全身|quánshēn|toàn thân|我感觉全身无力。|Wǒ gǎnjué quánshēn wúlì.|Tôi cảm thấy toàn thân vô lực.
至少|zhìshǎo|ít nhất|每天至少喝八杯水。|Měitiān zhìshǎo hē bā bēi shuǐ.|Mỗi ngày ít nhất uống 8 cốc nước.
