关系|guānxi|quan hệ|他和我的关系很好。|Tā hé wǒ de guānxì hěn hǎo.|Quan hệ giữa anh ấy và tôi rất tốt.
瓶子|píngzi|cái chai,lọ, bình|桌子上有一个瓶子。|Zhuōzi shàng yǒu yīgè píngzi.|Trên bàn có một cái chai.
体育|tǐyù|thể dục|我很喜欢体育。|Wǒ hěn xǐhuān tǐyù.|Tôi rất thích thể thao.
脸色|liǎnsè|sắc mặt|你的脸色不太好。|Nǐ de liǎnsè bù tài hǎo.|Sắc mặt của bạn không tốt lắm.
康复|kāngfù|bình phục, khỏe lại|祝你早日康复。|Zhù nǐ zǎorì kāngfù.|Chúc bạn sớm hồi phục.
借口|jièkǒu|cái cớ|他有很多借口。|Tā yǒu hěn duō jièkǒu.|Anh ấy có rất nhiều lý do.
健康|jiànkāng|sức khỏe, khỏe mạnh, lành mạnh|健康非常重要。|Jiànkāng fēicháng zhòngyào.|Sức khỏe rất quan trọng.
饮食|yǐnshí|ẩm thực, ăn uống|你的饮食习惯好吗？|Nǐ de yǐnshí xíguàn hǎo ma?|Thói quen ăn uống của bạn có tốt không?
甜品|tiánpǐn|đồ ngọt|我很喜欢吃甜品。|Wǒ hěn xǐhuān chī tiánpǐn.|Tôi rất thích ăn đồ ngọt.
压力|yālì|áp lực|我的学习压力很大。|Wǒ de xuéxí yālì hěn dà.|Áp lực học tập của tôi rất lớn.
轻音乐|qīng yīnyuè|nhạc nhẹ, nhạc không lời|听轻音乐可以放松。|Tīng qīng yīnyuè kěyǐ fàngsōng.|Nghe nhạc nhẹ có thể thư giãn.
效果|xiàoguǒ|hiệu quả|这个药的效果很好。|Zhège yào de xiàoguǒ hěn hǎo.|Hiệu quả của loại thuốc này rất tốt.
作息|zuòxī|làm việc và nghỉ ngơi|他作息时间不规律。|Tā zuòxī shíjiān bù guīlǜ.|Giờ giấc sinh hoạt của anh ấy không có quy luật.
心情|xīnqíng|tâm trạng|今天我心情很好。|Jīntiān wǒ xīnqíng hěn hǎo.|Hôm nay tâm trạng của tôi rất tốt.
味道|wèidào|mùi vị|这个菜的味道不错。|Zhège cài de wèidào bùcuò.|Món ăn này có vị khá ngon.
果汁|guǒzhī|nước ép trái cây|每天喝一杯果汁。|Měitiān hē yībēi guǒzhī.|Mỗi ngày uống một cốc nước ép trái cây.
生活|shēnghuó|cuộc sống, đời sống, sinh hoạt|我喜欢现在的生活。|Wǒ xǐhuān xiànzài de shēnghuó.|Tôi thích cuộc sống hiện tại.
草地|cǎodì|bãi cỏ|我们在草地上踢球。|Wǒmen zài cǎodì shàng tīqiú.|Chúng tôi đá bóng trên bãi cỏ.
维生素|wéishēngsù|vitamin|我需要补充维生素。|Wǒ xūyào bǔchōng wéishēngsù.|Tôi cần bổ sung vitamin.
纤维|xiānwéi|chất xơ|蔬菜里有很多纤维。|Shūcài lǐ yǒu hěn duō xiānwéi.|Trong rau có rất nhiều chất xơ.
力气|lìqi|sức, sức lực|我没力气搬这个桌子。|Wǒ méi lìqi bān zhège zhuōzi.|Tôi không có sức để bê cái bàn này.
牙科|yákē|Nha khoa|我要去牙科看牙。|Wǒ yào qù yákē kàn yá.|Tôi phải đến nha khoa khám răng.
难怪|nánguài|chẳng trách, hèn chi|难怪你这么累。|Nánguài nǐ zhème lèi.|Hèn chi bạn mệt như vậy.
眼泪|yǎnlèi|nước mắt|她流下了眼泪。|Tā liúxiàle yǎnlèi.|Cô ấy đã rơi nước mắt.
泪水|lèishuǐ|nước mắt|她的泪水停不下来。|Tā de lèishuǐ tíng bù xiàlái.|Nước mắt của cô ấy không ngừng rơi.
体检|tǐjiǎn|khám sức khỏe|我每年都做体检。|Wǒ měinián dōu zuò tǐjiǎn.|Tôi khám sức khỏe tổng quát hàng năm.
状况|zhuàngkuàng|tình trạng|他的身体状况很好。|Tā de shēntǐ zhuàngkuàng hěn hǎo.|Tình trạng sức khỏe của anh ấy rất tốt.
腰|yāo|eo, thắt lưng|我觉得腰有点疼。|Wǒ juédé yāo yǒudiǎn téng.|Tôi cảm thấy hơi đau lưng.
肚子|dùzi|bụng|我肚子很饿。|Wǒ dùzi hěn è.|Bụng của tôi rất đói.
胃脏|wèizàng|dạ dày|他的胃脏不太好。|Tā de wèizàng bù tài hǎo.|Dạ dày của anh ấy không tốt lắm.
肝脏|gānzàng|gan|喝酒对肝脏不好。|Hējiǔ duì gānzàng bù hǎo.|Uống rượu không tốt cho gan.
肺脏|fèizàng|phổi|吸烟会伤害肺脏。|Xīyān huì shānghài fèizàng.|Hút thuốc sẽ làm hại phổi.
心脏|xīnzàng|tim|心脏是身体的中心。|Xīnzàng shì shēntǐ de zhōngxīn.|Tim là trung tâm của cơ thể.
肾脏|shènzàng|thận|多喝水对肾脏好。|Duō hē shuǐ duì shènzàng hǎo.|Uống nhiều nước tốt cho thận.
汗|hàn|mồ hôi|运动后出了很多汗。|Yùndòng hòu chūle hěn duō hàn.|Sau khi vận động đã ra rất nhiều mồ hôi.
皮肤|pífū|da, làn da|她的皮肤很白。|Tā de pífū hěn bái.|Da của cô ấy rất trắng.
秘诀|mìjué|bí quyết|成功的秘诀是努力。|Chénggōng de mìjué shì nǔlì.|Bí quyết thành công là nỗ lực.
洗面奶|xǐmiànnǎi|sữa rửa mặt|她每天用洗面奶洗脸。|Tā měitiān yòng xǐmiànnǎi xǐ liǎn.|Hàng ngày cô ấy dùng sữa rửa mặt để rửa mặt.
面膜|miànmó|mặt nạ|晚上我会敷面膜。|Wǎnshàng wǒ huì fū miànmó.|Buổi tối tôi sẽ đắp mặt nạ.
瑜伽|yújiā|yoga|她喜欢练瑜伽。|Tā xǐhuān liàn yújiā.|Cô ấy thích tập yoga.
抑郁|yìyù|trầm cảm|抑郁症是一种病。|Yìyùzhèng shì yī zhǒng bìng.|Bệnh trầm cảm là một loại bệnh.
心理|xīnlǐ|tâm lý|保持健康的心理。|Bǎochí jiànkāng de xīnlǐ.|Giữ tâm lý khỏe mạnh.
能量|néngliàng|năng lượng|早餐可以补充能量。|Zǎocān kěyǐ bǔchōng néngliàng.|Bữa sáng có thể bổ sung năng lượng.
生命|shēngmìng|sinh mệnh, sự sống|生命只有一次。|Shēngmìng zhǐyǒu yīcì.|Sinh mệnh chỉ có một lần.
源|yuán|nguồn|运动是快乐的源头。|Yùndòng shì kuàilè de yuántóu.|Vận động là nguồn gốc của niềm vui.
毒素|dúsù|độc tố|运动可以排出毒素。|Yùndòng kěyǐ páichū dúsù.|Vận động có thể đào thải độc tố.
水分|shuǐfèn|nước, lượng nước|身体需要很多水分。|Shēntǐ xūyào hěn duō shuǐfèn.|Cơ thể cần rất nhiều nước.
预防|yùfáng|phòng ngừa|预防疾病很重要。|Yùfáng jíbìng hěn zhòngyào.|Phòng ngừa bệnh tật rất quan trọng.
疾病|jíbìng|bệnh tật|很多疾病可以预防。|Hěn duō jíbìng kěyǐ yùfáng.|Rất nhiều bệnh tật có thể phòng ngừa.
活力|huólì|sức sống|她看起来很有活力。|Tā kàn qǐlái hěn yǒu huólì.|Cô ấy trông rất tràn đầy sức sống.
烟|yān|thuốc lá|他已经不抽烟了。|Tā yǐjīng bù chōuyānle.|Anh ấy đã không hút thuốc nữa.
睡眠|shuìmián|giấc ngủ|我需要充足的睡眠。|Wǒ xūyào chōngzú de shuìmián.|Tôi cần một giấc ngủ đầy đủ.
次数|cìshù|số lần|你一个月锻炼几次？|Nǐ yīgè yuè duànliàn jǐ cì?|Bạn tập thể dục mấy lần một tháng?
习惯|xíguàn|thói quen|养成好习惯。|Yǎngchéng hǎo xíguàn.|Hình thành thói quen tốt.
担心|dānxīn|lo lắng|我很担心你的健康。|Wǒ hěn dānxīn nǐ de jiànkāng.|Tôi rất lo lắng cho sức khỏe của bạn.
锻炼|duànliàn|rèn luyện|每天都要锻炼身体。|Měitiān dū yào duànliàn shēntǐ.|Mỗi ngày đều phải tập thể dục.
关心|guānxīn|quan tâm|父母很关心我。|Fùmǔ hěn guānxīn wǒ.|Bố mẹ rất quan tâm đến tôi.
难过|nánguò|buồn bã, đau lòng|听到这个消息我很难过。|Tīng dào zhège xiāoxī wǒ hěn nánguò.|Nghe tin này tôi rất buồn.
打针|dǎzhēn|tiêm thuốc|孩子害怕打针。|Háizi hàipà dǎzhēn.|Đứa trẻ sợ tiêm thuốc.
坚持|jiānchí|kiên trì|坚持锻炼对身体好。|Jiānchí duànliàn duì shēntǐ hǎo.|Kiên trì tập thể dục tốt cho sức khỏe.
得|dé|phải|他得了重感冒。|Tā déliǎo zhòng gǎnmào.|Anh ấy bị cảm nặng.
着|zháo|trợ từ|昨晚我睡着了。|Zuó wǎn wǒ shuìzháole.|Tối qua tôi đã ngủ rồi.
闭|bì|nhắm, đóng|请你闭上眼睛。|Qǐng nǐ bì shàng yǎnjīng.|Xin bạn hãy nhắm mắt lại.
睡不着|shuì bù zháo|ngủ không được|晚上我总是睡不着。|Wǎnshàng wǒ zǒng shì shuì bù zháo.|Buổi tối tôi luôn không ngủ được.
熬夜|áoyè|thức khuya|熬夜对身体不好。|Áoyè duì shēntǐ bù hǎo.|Thức khuya không tốt cho sức khỏe.
注意|zhùyì|chú ý|你要注意休息。|Nǐ yào zhùyì xiūxí.|Bạn phải chú ý nghỉ ngơi.
提醒|tíxǐng|nhắc nhở|妈妈提醒我早睡。|Māmā tíxǐng wǒ zǎo shuì.|Mẹ nhắc tôi ngủ sớm.
放松|fàngsōng|thư giãn, thả lỏng, buông lỏng|我需要放松一下。|Wǒ xūyào fàngsōng yīxià.|Tôi cần thư giãn một chút.
重视|zhòngshì|coi trọng|我们应该重视健康。|Wǒmen yīnggāi zhòngshì jiànkāng.|Chúng ta nên coi trọng sức khỏe.
调整|tiáozhěng|điều chỉnh|我在调整我的作息。|Wǒ zài tiáozhěng wǒ de zuòxī.|Tôi đang điều chỉnh giờ giấc sinh hoạt của mình.
相信|xiāngxìn|tin,tin tưởng,tin rằng|我相信他能做到。|Wǒ xiāngxìn tā néng zuò dào.|Tôi tin anh ấy có thể làm được.
补充|bǔchōng|bổ sung|补充一些水分。|Bǔchōng yīxiē shuǐfèn.|Bổ sung một ít nước.
缺少|quēshǎo|thiếu|他缺少锻炼。|Tā quēshǎo duànliàn.|Anh ấy thiếu rèn luyện.
捂|wǔ|che, bịt|他用手捂着肚子。|Tā yòng shǒu wǔzhe dùzi.|Anh ấy dùng tay ôm bụng.
疼|téng|đau|我的头很疼。|Wǒ de tóu hěn téng.|Đầu của tôi rất đau.
止痛|zhǐtòng|giảm đau|这种药可以止痛。|Zhè zhǒng yào kěyǐ zhǐtòng.|Loại thuốc này có thể giảm đau.
保护|bǎohù|bảo vệ|保护眼睛很重要。|Bǎohù yǎnjīng hěn zhòngyào.|Bảo vệ mắt rất quan trọng.
负责|fùzé|chịu trách nhiệm|我们要对健康负责。|Wǒmen yào duì jiànkāng fùzé.|Chúng ta phải chịu trách nhiệm với sức khỏe.
按时|ànshí|đúng giờ|我每天按时吃饭。|Wǒ měitiān ànshí chīfàn.|Mỗi ngày tôi ăn cơm đúng giờ.
减肥|jiǎnféi|giảm cân|她正在努力减肥。|Tā zhèngzài nǔlì jiǎnféi.|Cô ấy đang cố gắng giảm cân.
控制|kòngzhì|kiểm soát, khống chế, điều khiển|我要控制体重。|Wǒ yào kòngzhì tǐzhòng.|Tôi phải kiểm soát cân nặng.
敷|fū|đắp, thoa, bôi|她很少敷面膜。|Tā hěn shǎo fū miànmó.|Cô ấy rất ít khi đắp mặt lạ.
鼓励|gǔlì|khuyến khích, khích lệ, cổ vũ|老师鼓励我们学习。|Lǎoshī gǔlì wǒmen xuéxí.|Thầy giáo khuyến khích chúng tôi học tập.
恢复|huīfù|khôi phục|他很快恢复了健康。|Tā hěn kuài huīfùle jiànkāng.|Anh ấy đã sớm phục hồi sức khỏe.
排除|páichú|loại bỏ|运动可以排除毒素。|Yùndòng kěyǐ páichú dúsù.|Vận động có thể loại bỏ độc tố.
保持|bǎochí|giữ, duy trì|我们要保持好心情。|Wǒmen yào bǎochí hǎo xīnqíng.|Chúng ta phải giữ tâm trạng tốt.
戒|jiè|cai|他决心戒烟。|Tā juéxīn jièyān.|Anh ấy quyết tâm cai thuốc lá.
减少|jiǎnshǎo|giảm bớt|我们要减少垃圾。|Wǒmen yào jiǎnshǎo lājī.|Chúng ta phải giảm rác thải.
增加|zēngjiā|tăng thêm|我增加了运动时间。|Wǒ zēngjiāle yùndòng shíjiān.|Tôi đã tăng thời gian vận động.
伤害|shānghài|làm tổn thương|熬夜会伤害身体。|Áoyè huì shānghài shēntǐ.|Thức khuya sẽ làm hại cơ thể.
治疗|zhìliáo|chữa bệnh, điều trị|这种病很难治疗。|Zhè zhǒng bìng hěn nán zhìliáo.|Căn bệnh này rất khó điều trị.
习惯|xíguàn|quen|我已经习惯早起了。|Wǒ yǐjīng xíguàn zǎo qǐle.|Tôi đã quen với việc dậy sớm rồi.
失眠|shīmián|mất ngủ|他最近总是失眠。|Tā zuìjìn zǒngshì shīmián.|Gần đây anh ấy luôn bị mất ngủ.
冒|mào|toát ra, bốc lên|他冒了一身冷汗。|Tā màole yīshēn lěnghàn.|Anh ấy toát mồ hôi lạnh toàn thân.
几乎|jīhū|gần như|我几乎忘了这件事。|Wǒ jīhū wàngle zhè jiàn shì.|Tôi gần như đã quên chuyện này.
努力|nǔlì|nỗ lực|我们要努力学习。|Wǒmen yào nǔlì xuéxí.|Chúng ta phải cố gắng học tập.
其实|qíshí|thật ra|其实他并不开心。|Qíshí tā bìng bù kāixīn.|Thật ra anh ấy không vui.
实在|shízài|thật sự, quả thực|我实在太累了。|Wǒ shízài tài lèile.|Tôi thực sự quá mệt rồi.
奇怪|qíguài|kỳ lạ|我觉得这件事很奇怪。|Wǒ juédé zhè jiàn shì hěn qíguài.|Tôi cảm thấy chuyện này rất kỳ lạ.
清淡|qīngdàn|thanh đạm|医生建议饮食清淡。|Yīshēng jiànyì yǐnshí qīngdàn.|Bác sĩ khuyên nên ăn uống thanh đạm.
改变|gǎibiàn|thay đổi|他改变了生活习惯。|Tā gǎibiànle shēnghuó xíguàn.|Anh ấy đã thay đổi thói quen sinh hoạt.
没有用|méiyǒu yòng|không tác dụng|这个方法没有用。|Zhège fāngfǎ méiyǒu yòng.|Phương pháp này không có tác dụng.
规律|guīlǜ|quy luật, điều độ|她的生活很有规律。|Tā de shēnghuó hěn yǒu guīlǜ.|Cuộc sống của cô ấy rất có quy luật.
严重|yánzhòng|nghiêm trọng|这个问题很严重。|Zhège wèntí hěn yánzhòng.|Vấn đề này rất nghiêm trọng.
难受|nánshòu|khó chịu|我感觉身体很难受。|Wǒ gǎnjué shēntǐ hěn nánshòu.|Tôi cảm thấy cơ thể rất khó chịu.
当然|dāngrán|đương nhiên|当然，我可以帮你。|Dāngrán, wǒ kěyǐ bāng nǐ.|Đương nhiên, tôi có thể giúp bạn.
过度|guòdù|quá độ, quá mức|他工作过度了。|Tā gōngzuò guòdùle.|Anh ấy đã làm việc quá độ rồi.
疲劳|píláo|mệt mỏi|我感觉很疲劳。|Wǒ gǎnjué hěn píláo.|Tôi cảm thấy rất mệt mỏi.
干|gān|khô|皮肤变得很干。|Pífū biànde hěn gān.|Da trở nên rất khô.
湿|shī|ướt|衣服被雨淋湿了。|Yīfú bèi yǔ lín shīle.|Quần áo bị mưa làm ướt.
好好|hǎohāo||你要好好休息。|Nǐ yào hǎohāo xiūxí.|Bạn phải nghỉ ngơi thật tốt.
常见|chángjiàn|thường gặp|这是常见的问题。|Zhè shì chángjiàn de wèntí.|Đây là một vấn đề thường gặp.
定期|dìngqī|định kỳ|他定期去体检。|Tā dìngqī qù tǐjiǎn.|Anh ấy đi khám sức khỏe định kỳ.
苍白|cāngbái|tái nhợt, nhợt nhạt|他的脸色苍白。|Tā de liǎnsè cāngbái.|Sắc mặt của anh ấy trắng bệch.
懒|lǎn|lười|我不想动，我太懒了。|Wǒ bù xiǎng dòng, wǒ tài lǎnle.|Tôi không muốn cử động, tôi quá lười.
勤奋|qínfèn|cần cù, siêng năng|他是一个勤奋的学生。|Tā shì yīgè qínfèn de xuéshēng.|Anh ấy là một học sinh siêng năng.
值得|zhídé|đáng giá, đáng để, đáng|这件事很值得做。|Zhè jiàn shì hěn zhídé zuò.|Chuyện này rất đáng để làm.
直接|zhíjiē|trực tiếp|你直接告诉我吧。|Nǐ zhíjiē gàosù wǒ ba.|Bạn nói thẳng cho tôi biết đi.
着急|zháojí|sốt ruột, nóng vội, vội vàng, |你别着急，慢慢来。|Nǐ bié zháojí, màn man lái.|Bạn đừng lo, từ từ thôi.
害|hài|hại, có hại, làm hại|熬夜很害身体。|Áoyè hěn hài shēntǐ.|Thức khuya rất có hại cho cơ thể.
傍晚|bàngwǎn|xế chiều, chập tối, chiều tối|傍晚我们去散步。|Bàngwǎn wǒmen qù sànbù.|Xế chiều chúng tôi đi dạo.
全身|quánshēn|toàn thân|我感觉全身无力。|Wǒ gǎnjué quánshēn wúlì.|Tôi cảm thấy toàn thân vô lực.
至少|zhìshǎo|ít nhất|你至少要休息两天。|Nǐ zhìshǎo yào xiūxí liǎng tiān.|Bạn ít nhất phải nghỉ ngơi hai ngày.
