给 | gěi | đưa, cho | 他给了我一本书。| Tā gěi le wǒ yì běn shū. | Anh ấy đưa cho tôi một quyển sách.
请 | qǐng | mời / xin | 请你进来。| Qǐng nǐ jìnlái. | Mời bạn vào.
问 | wèn | hỏi | 我可以问你一个问题吗？| Wǒ kěyǐ wèn nǐ yí gè wèntí ma? | Tôi có thể hỏi bạn một câu không?
住 | zhù | sống, ở | 我住在河内。| Wǒ zhù zài Hénèi. | Tôi sống ở Hà Nội.
称 | chēng | gọi, xưng hô | 他称我为朋友。| Tā chēng wǒ wéi péngyǒu. | Anh ấy gọi tôi là bạn.
找 | zhǎo | tìm, trả lại (tiền) | 我在找我的手机。| Wǒ zài zhǎo wǒ de shǒujī. | Tôi đang tìm điện thoại của mình.
卖 | mài | bán | 他在市场卖水果。| Tā zài shìchǎng mài shuǐguǒ. | Anh ấy bán trái cây ở chợ.
尝 | cháng | nếm thử | 你想尝尝这个菜吗？| Nǐ xiǎng chángchang zhège cài ma? | Bạn muốn nếm thử món này không?
试 | shì | thử | 我可以试穿这件衣服吗？| Wǒ kěyǐ shì chuān zhè jiàn yīfu ma? | Tôi có thể thử bộ đồ này không?
借 | jiè | mượn | 我想借一本书。| Wǒ xiǎng jiè yì běn shū. | Tôi muốn mượn một quyển sách.
指 | zhǐ | chỉ (bằng tay) | 他指着那家店。| Tā zhǐzhe nà jiā diàn. | Anh ấy đang chỉ vào cửa hàng kia.
还 | huán | trả lại | 我会还你钱的。| Wǒ huì huán nǐ qián de. | Tôi sẽ trả tiền cho bạn.
算 | suàn | tính toán | 请帮我算一下多少钱。| Qǐng bāng wǒ suàn yíxià duōshao qián. | Làm ơn tính giúp tôi xem bao nhiêu tiền.
扫 | sǎo | quét | 我每天扫地。| Wǒ měitiān sǎodì. | Tôi quét nhà mỗi ngày.
刷 | shuā | đánh (răng), quét (thẻ) | 他在刷牙。| Tā zài shuāyá. | Anh ấy đang đánh răng.
离 | lí | cách, rời khỏi | 学校离我家很近。| Xuéxiào lí wǒ jiā hěn jìn. | Trường học cách nhà tôi rất gần.
走 | zǒu | đi bộ, rời đi | 我们走吧。| Wǒmen zǒu ba. | Chúng ta đi thôi.
认识 | rènshi | quen biết | 我认识他。| Wǒ rènshi tā. | Tôi quen anh ấy.
聊天 | liáotiān | trò chuyện | 我喜欢和朋友聊天。| Wǒ xǐhuān hé péngyǒu liáotiān. | Tôi thích trò chuyện với bạn bè.
开车 | kāichē | lái xe | 他正在开车。| Tā zhèngzài kāichē. | Anh ấy đang lái xe.
看见 | kànjiàn | nhìn thấy | 我看见他进去了。| Wǒ kànjiàn tā jìnqù le. | Tôi thấy anh ấy đã vào rồi.
稍等 | shāo děng | đợi một chút | 请稍等一下。| Qǐng shāo děng yíxià. | Xin đợi một chút.
推荐 | tuījiàn | giới thiệu, đề xuất | 你有什么好电影推荐吗？| Nǐ yǒu shénme hǎo diànyǐng tuījiàn ma? | Bạn có phim hay nào đề xuất không?
完 | wán | xong, kết thúc | 我已经做完作业了。| Wǒ yǐjīng zuò wán zuòyè le. | Tôi đã làm xong bài tập rồi.
购物 | gòuwù | mua sắm | 女孩们喜欢购物。| Nǚhái men xǐhuān gòuwù. | Các cô gái thích mua sắm.
打折 | dǎzhé | giảm giá | 这件衣服打八折。| Zhè jiàn yīfu dǎ bā zhé. | Bộ đồ này giảm 20%.
讨价还价 | tǎojià huánjià | mặc cả | 她买东西总是讨价还价。| Tā mǎi dōngxi zǒngshì tǎojià huánjià. | Cô ấy luôn mặc cả khi mua đồ.
打扰 | dǎrǎo | làm phiền | 不好意思，打扰一下。| Bù hǎoyìsi, dǎrǎo yíxià. | Xin lỗi, làm phiền một chút.
对不起 | duìbuqǐ | xin lỗi | 对不起，我来晚了。| Duìbuqǐ, wǒ lái wǎn le. | Xin lỗi, tôi đến muộn rồi.
不客气 | bú kèqi | không có chi | 谢谢你！不客气。| Xièxie nǐ! Bú kèqi. | Cảm ơn bạn! Không có chi.
欢迎 | huānyíng | hoan nghênh | 欢迎来到我们学校。| Huānyíng láidào wǒmen xuéxiào. | Chào mừng đến với trường chúng tôi.
拐 | guǎi | rẽ | 前面左拐。| Qiánmiàn zuǒ guǎi. | Phía trước rẽ trái.
转 | zhuǎn | xoay, rẽ | 你右转就到了。| Nǐ yòu zhuǎn jiù dào le. | Bạn rẽ phải là đến nơi rồi.
往 | wǎng | hướng, về | 请往前走。| Qǐng wǎng qián zǒu. | Mời đi thẳng.
付款 | fùkuǎn | thanh toán | 请到收银台付款。| Qǐng dào shōuyíntái fùkuǎn. | Hãy thanh toán ở quầy thu ngân.
看见 | kànjiàn | nhìn thấy | 我看见他进去了。| Wǒ kànjiàn tā jìnqù le. | Tôi thấy anh ấy đã vào rồi.
人民币 | rénmínbì | Nhân dân tệ | 一百人民币够吗？| Yì bǎi rénmínbì gòu ma? | Một trăm tệ đủ không?
元 | yuán | đồng (tệ) | 这本书五十元。| Zhè běn shū wǔshí yuán. | Cuốn sách này 50 tệ.
角 | jiǎo | hào (1/10 tệ) | 这支笔八角钱。| Zhè zhī bǐ bā jiǎo qián. | Cây bút này 0,8 tệ.
分 | fēn | xu (1/100 tệ) | 一块糖两分。| Yí kuài táng liǎng fēn. | Một viên kẹo hai xu.
块 | kuài | đồng (tệ) | 这本书五十块。| Zhè běn shū wǔshí kuài. | Quyển sách này 50 tệ.
毛 | máo | hào (1/10 tệ) | 一瓶水两毛。| Yì píng shuǐ liǎng máo. | Một chai nước 2 hào.
斤 | jīn | 0.5kg (cân Trung Quốc) | 我买了一斤苹果。| Wǒ mǎi le yì jīn píngguǒ. | Tôi mua nửa ký táo.
两 | liǎng | hai (trước lượng từ) | 我有两本书。| Wǒ yǒu liǎng běn shū. | Tôi có hai quyển sách.
公斤 | gōngjīn | kilogram | 我想买一公斤米。| Wǒ xiǎng mǎi yì gōngjīn mǐ. | Tôi muốn mua một ký gạo.
克 | kè | gam | 这块蛋糕一百克。| Zhè kuài dàngāo yì bǎi kè. | Miếng bánh này 100 gram.
毫米 | háomǐ | millimet | 这个螺丝长五毫米。| Zhège luósī zhǎng wǔ háomǐ. | Con ốc này dài 5 mm.
厘米 | límǐ | centimet | 这张纸宽三厘米。| Zhè zhāng zhǐ kuān sān límǐ. | Tờ giấy này rộng 3 cm.
分米 | fēnmǐ | decimet | 他身高十五分米。| Tā shēngāo shíwǔ fēnmǐ. | Cậu ấy cao 1,5m.
米 | mǐ | mét | 房间有三米长。| Fángjiān yǒu sān mǐ cháng. | Căn phòng dài 3 mét.
公里 | gōnglǐ | kilomet | 学校离家五公里。| Xuéxiào lí jiā wǔ gōnglǐ. | Trường cách nhà 5 km.
上 | shàng | trên / lên | 把书放在桌子上。| Bǎ shū fàng zài zhuōzi shàng. | Đặt sách lên bàn.
下 | xià | dưới / xuống | 鞋在床下。| Xié zài chuáng xià. | Giày ở dưới giường.
外 | wài | ngoài | 他在外面等你。| Tā zài wàimiàn děng nǐ. | Anh ấy đang đợi bạn ở ngoài.
里 | lǐ | trong | 钱包在包里。| Qiánbāo zài bāo lǐ. | Ví ở trong túi.
前 | qián | trước | 他站在我前面。| Tā zhàn zài wǒ qiánmiàn. | Anh ấy đứng trước tôi.
后 | hòu | sau | 她走在我后面。| Tā zǒu zài wǒ hòumiàn. | Cô ấy đi phía sau tôi.
左 | zuǒ | trái | 银行在左边。| Yínháng zài zuǒbiān. | Ngân hàng ở bên trái.
右 | yòu | phải | 医院在右边。| Yīyuàn zài yòubiān. | Bệnh viện ở bên phải.
对 | duì | đối diện / đúng | 学校对面是商店。| Xuéxiào duìmiàn shì shāngdiàn. | Đối diện trường là cửa hàng.
旁 | páng | bên cạnh | 他坐在我旁边。| Tā zuò zài wǒ pángbiān. | Anh ấy ngồi bên cạnh tôi.
边 | biān | cạnh / bên | 桌子旁边有个椅子。| Zhuōzi pángbiān yǒu gè yǐzi. | Bên cạnh bàn có cái ghế.
面 | miàn | mặt / phía | 墙的一面是白色的。| Qiáng de yí miàn shì báisè de. | Một mặt của bức tường màu trắng.
种 | zhǒng | loại | 你喜欢哪种颜色？| Nǐ xǐhuān nǎ zhǒng yánsè? | Bạn thích màu nào?
卡 | kǎ | thẻ | 这是一张银行卡。| Zhè shì yì zhāng yínhángkǎ. | Đây là thẻ ngân hàng.
第 | dì | thứ (số thứ tự) | 我是第一个到的。| Wǒ shì dì yī gè dào de. | Tôi là người đến đầu tiên.
价格 | jiàgé | giá cả | 这个产品的价格是多少？| Zhège chǎnpǐn de jiàgé shì duōshao? | Giá của sản phẩm này là bao nhiêu?
原价 | yuánjià | giá gốc | 衣服原价是一百块。| Yīfu yuánjià shì yì bǎi kuài. | Giá gốc của áo là 100 tệ.
现金 | xiànjīn | tiền mặt | 请用现金付款。| Qǐng yòng xiànjīn fùkuǎn. | Vui lòng thanh toán bằng tiền mặt.
钱 | qián | tiền | 我没有钱了。| Wǒ méiyǒu qián le. | Tôi hết tiền rồi.
零钱 | língqián | tiền lẻ | 我只有零钱。| Wǒ zhǐyǒu língqián. | Tôi chỉ có tiền lẻ.
出口 | chūkǒu | lối ra | 那边是出口。| Nà biān shì chūkǒu. | Bên đó là lối ra.
无线 | wúxiàn | không dây | 我家有无线网络。| Wǒ jiā yǒu wúxiàn wǎngluò. | Nhà tôi có mạng không dây.
电话 | diànhuà | điện thoại bàn | 请给我打电话。| Qǐng gěi wǒ dǎ diànhuà. | Hãy gọi điện cho tôi.
手机 | shǒujī | điện thoại di động | 我的手机没电了。| Wǒ de shǒujī méi diàn le. | Điện thoại tôi hết pin rồi.
耳机 | ěrjī | tai nghe | 我带着耳机听音乐。| Wǒ dàizhe ěrjī tīng yīnyuè. | Tôi đang đeo tai nghe nghe nhạc.
充电宝 | chōngdiànbǎo | sạc dự phòng | 你有充电宝吗？| Nǐ yǒu chōngdiànbǎo ma? | Bạn có sạc dự phòng không?
码 | mǎ | mã | 请扫描这个二维码。| Qǐng sǎomiáo zhège èrwéimǎ. | Hãy quét mã QR này.
号码 | hàomǎ | số (mã số) | 请告诉我你的手机号码。| Qǐng gàosu wǒ nǐ de shǒujī hàomǎ. | Hãy cho tôi số điện thoại của bạn.
高兴 | gāoxìng | vui vẻ | 我很高兴认识你。| Wǒ hěn gāoxìng rènshi nǐ. | Tôi rất vui được làm quen với bạn.
开心 | kāixīn | vui vẻ | 他今天很开心。| Tā jīntiān hěn kāixīn. | Hôm nay anh ấy rất vui.
出租车 | chūzūchē | taxi | 我们坐出租车去机场。| Wǒmen zuò chūzūchē qù jīchǎng. | Chúng tôi đi taxi đến sân bay.
没关系 | méi guānxi | không sao / không vấn đề | 对不起！—没关系。| Duìbuqǐ! — Méi guānxi. | Xin lỗi! — Không sao đâu.
电脑 | diànnǎo | máy tính | 我的电脑坏了。| Wǒ de diànnǎo huài le. | Máy tính của tôi bị hỏng.
笔记本电脑 | bǐjìběn diànnǎo | laptop | 他带着笔记本电脑去上课。| Tā dàizhe bǐjìběn diànnǎo qù shàngkè. | Anh ấy mang laptop đi học.
飞机 | fēijī | máy bay | 我第一次坐飞机。| Wǒ dì yī cì zuò fēijī. | Đây là lần đầu tôi đi máy bay.
火车站 | huǒchēzhàn | ga tàu | 火车站在前面。| Huǒchēzhàn zài qiánmiàn. | Ga tàu ở phía trước.
收银台 | shōuyíntái | quầy thu ngân | 请到收银台付款。| Qǐng dào shōuyíntái fùkuǎn. | Hãy thanh toán ở quầy thu ngân.
蔬菜 | shūcài | rau củ | 我每天吃很多蔬菜。| Wǒ měitiān chī hěn duō shūcài. | Tôi ăn nhiều rau mỗi ngày.
肉 | ròu | thịt | 我喜欢吃牛肉。| Wǒ xǐhuān chī niúròu. | Tôi thích ăn thịt bò.
鸡 | jī | gà | 晚饭吃的是鸡肉。| Wǎnfàn chī de shì jīròu. | Bữa tối ăn thịt gà.
猪 | zhū | lợn | 这道菜是猪肉做的。| Zhè dào cài shì zhūròu zuò de. | Món này làm từ thịt lợn.
牛 | niú | bò | 她不吃牛肉。| Tā bù chī niúròu. | Cô ấy không ăn thịt bò.
鱼 | yú | cá | 我喜欢吃清蒸鱼。| Wǒ xǐhuān chī qīngzhēng yú. | Tôi thích ăn cá hấp.
筷子 | kuàizi | đũa | 你会用筷子吗？| Nǐ huì yòng kuàizi ma? | Bạn biết dùng đũa không?
碗 | wǎn | bát | 我要一碗米饭。| Wǒ yào yì wǎn mǐfàn. | Tôi muốn một bát cơm.
饺子 | jiǎozi | bánh chẻo | 饺子是中国传统食物。| Jiǎozi shì Zhōngguó chuántǒng shíwù. | Bánh chẻo là món ăn truyền thống của Trung Quốc.
汤 | tāng | canh | 我妈妈做的汤很好喝。| Wǒ māma zuò de tāng hěn hǎohē. | Canh mẹ tôi nấu rất ngon.
灯 | dēng | đèn | 请开灯。| Qǐng kāi dēng. | Hãy bật đèn.
苹果 | píngguǒ | táo | 苹果是我最喜欢的水果。| Píngguǒ shì wǒ zuì xǐhuān de shuǐguǒ. | Táo là loại trái cây tôi thích nhất.
橘子 | júzi | quýt | 桌上有几个橘子。| Zhuō shàng yǒu jǐ gè júzi. | Trên bàn có vài quả quýt.
香蕉 | xiāngjiāo | chuối | 我早餐吃一个香蕉。| Wǒ zǎocān chī yí gè xiāngjiāo. | Tôi ăn một quả chuối vào bữa sáng.
西瓜 | xīguā | dưa hấu | 夏天吃西瓜很凉快。| Xiàtiān chī xīguā hěn liángkuai. | Mùa hè ăn dưa hấu rất mát.
草莓 | cǎoméi | dâu tây | 你喜欢草莓吗？| Nǐ xǐhuān cǎoméi ma? | Bạn có thích dâu không?
葡萄 | pútao | nho | 葡萄甜甜的。| Pútao tián tián de. | Nho rất ngọt.
红枣 | hóngzǎo | táo tàu | 红枣对身体很好。| Hóngzǎo duì shēntǐ hěn hǎo. | Táo tàu rất tốt cho sức khỏe.
梨 | lí | lê | 我不太喜欢吃梨。| Wǒ bù tài xǐhuān chī lí. | Tôi không thích ăn lê lắm.
桃子 | táozi | đào | 桃子很好吃。| Táozi hěn hǎochī. | Quả đào rất ngon.
橙子 | chéngzi | cam | 橙子富含维生素C。| Chéngzi fùhán wéishēngsù C. | Cam giàu vitamin C.
西红柿 | xīhóngshì | cà chua | 西红柿炒鸡蛋很好吃。| Xīhóngshì chǎo jīdàn hěn hǎochī. | Trứng xào cà chua rất ngon.
番茄 | fānqié | cà chua (tên gọi khác) | 番茄就是西红柿。| Fānqié jiùshì xīhóngshì. | "Fānqié" chính là cà chua.
黄瓜 | huángguā | dưa leo | 我喜欢吃凉拌黄瓜。| Wǒ xǐhuān chī liángbàn huángguā. | Tôi thích ăn dưa leo trộn.
鞋 | xié | giày | 我买了一双新鞋。| Wǒ mǎi le yì shuāng xīn xié. | Tôi mua một đôi giày mới.
运动鞋 | yùndòngxié | giày thể thao | 他穿着运动鞋打篮球。| Tā chuānzhe yùndòngxié dǎ lánqiú. | Anh ấy mang giày thể thao chơi bóng rổ.
拖鞋 | tuōxié | dép lê | 我在家穿拖鞋。| Wǒ zài jiā chuān tuōxié. | Tôi mang dép trong nhà.
毛衣 | máoyī | áo len | 冬天我常穿毛衣。| Dōngtiān wǒ cháng chuān máoyī. | Mùa đông tôi thường mặc áo len.
裙子 | qúnzi | váy | 她穿了一条红裙子。| Tā chuān le yì tiáo hóng qúnzi. | Cô ấy mặc một chiếc váy đỏ.
衬衫 | chènshān | áo sơ mi | 我爸爸喜欢穿衬衫。| Wǒ bàba xǐhuān chuān chènshān. | Bố tôi thích mặc áo sơ mi.
外套 | wàitào | áo khoác | 外面冷，穿外套吧。| Wàimiàn lěng, chuān wàitào ba. | Ngoài trời lạnh, mặc áo khoác đi.
T恤 | T xù | áo thun | 他今天穿了一件白T恤。| Tā jīntiān chuān le yí jiàn bái T xù. | Hôm nay anh ấy mặc một áo thun trắng.
尺寸 | chǐcùn | kích cỡ | 请问这件衣服的尺寸是多少？| Qǐngwèn zhè jiàn yīfu de chǐcùn shì duōshao? | Cho hỏi kích cỡ của bộ đồ này là bao nhiêu?
试衣间 | shìyījiān | phòng thử đồ | 试衣间在那边。| Shìyījiān zài nàbiān. | Phòng thử đồ ở đằng kia.
款式 | kuǎnshì | kiểu dáng | 这个款式很时尚。| Zhège kuǎnshì hěn shíshàng. | Kiểu này rất thời trang.
品 | pǐn | sản phẩm | 这个品牌的产品很好。| Zhège pǐnpái de chǎnpǐn hěn hǎo. | Sản phẩm của thương hiệu này rất tốt.
生活 | shēnghuó | cuộc sống | 我们的生活越来越好。| Wǒmen de shēnghuó yuè lái yuè hǎo. | Cuộc sống của chúng tôi ngày càng tốt hơn.
袋子 | dàizi | túi | 请给我一个袋子。| Qǐng gěi wǒ yí gè dàizi. | Làm ơn cho tôi một cái túi.
盒 | hé | hộp | 我要一盒牛奶。| Wǒ yào yì hé niúnǎi. | Tôi muốn một hộp sữa.
品牌 | pǐnpái | thương hiệu | 这是一个国际品牌。| Zhè shì yí gè guójì pǐnpái. | Đây là một thương hiệu quốc tế.
附近 | fùjìn | gần đây | 附近有超市吗？| Fùjìn yǒu chāoshì ma? | Gần đây có siêu thị không?
路口 | lùkǒu | ngã tư | 在下一个路口右转。| Zài xià yí gè lùkǒu yòu zhuǎn. | Rẽ phải ở ngã tư tiếp theo.
斑马线 | bānmǎxiàn | vạch qua đường | 请走斑马线。| Qǐng zǒu bānmǎxiàn. | Xin đi qua vạch trắng.
位置 | wèizhì | vị trí | 这个位置很好。| Zhège wèizhì hěn hǎo. | Vị trí này rất tốt.
食堂 | shítáng | nhà ăn | 学校有一个大食堂。| Xuéxiào yǒu yí gè dà shítáng. | Trường có một nhà ăn lớn.
公交车 | gōngjiāochē | xe buýt | 我坐公交车上学。| Wǒ zuò gōngjiāochē shàngxué. | Tôi đi xe buýt đến trường.
服务员 | fúwùyuán | nhân viên phục vụ | 服务员，请买单！| Fúwùyuán, qǐng mǎidān! | Phục vụ ơi, tính tiền giúp!
尽头 | jìntóu | cuối đường | 洗手间在走廊的尽头。| Xǐshǒujiān zài zǒuláng de jìntóu. | Nhà vệ sinh ở cuối hành lang.
一直 | yìzhí | suốt / luôn / thẳng | 一直走就到了。| Yìzhí zǒu jiù dàole. | Đi thẳng là đến.
一共 | yígòng | tổng cộng | 一共多少钱？| Yígòng duōshao qián? | Tổng cộng bao nhiêu tiền?
一下 | yíxià | một chút | 请等我一下。| Qǐng děng wǒ yíxià. | Xin đợi tôi một chút.
别的 | biéde | cái khác | 你还有别的吗？| Nǐ hái yǒu biéde ma? | Bạn còn cái nào khác không?
其他 | qítā | những cái khác | 我不喜欢其他颜色。| Wǒ bù xǐhuān qítā yánsè. | Tôi không thích màu khác.
具体 | jùtǐ | cụ thể | 请说得具体一点。| Qǐng shuō de jùtǐ yìdiǎn. | Hãy nói cụ thể hơn.
当然 | dāngrán | đương nhiên | 你喜欢吃饺子吗？—当然！| Nǐ xǐhuān chī jiǎozi ma?—Dāngrán! | Bạn thích ăn bánh chẻo không? — Đương nhiên rồi!
大概 | dàgài | khoảng / đại khái | 他大概三十岁。| Tā dàgài sānshí suì. | Anh ấy khoảng 30 tuổi.
正好 | zhènghǎo | vừa đúng / đúng lúc | 你来得正好。| Nǐ lái de zhènghǎo. | Bạn đến đúng lúc đấy.
就 | jiù | thì / liền | 我一到家就吃饭。| Wǒ yí dào jiā jiù chīfàn. | Tôi vừa về đến nhà là ăn cơm ngay.
新鲜 | xīnxiān | tươi | 水果很新鲜。| Shuǐguǒ hěn xīnxiān. | Trái cây rất tươi.
容易 | róngyì | dễ | 这个问题很容易。| Zhège wèntí hěn róngyì. | Câu hỏi này rất dễ.
这些 | zhèxiē | những cái này | 这些苹果是谁买的？| Zhèxiē píngguǒ shì shéi mǎi de? | Những quả táo này ai mua vậy?
那些 | nàxiē | những cái kia | 我不喜欢那些颜色。| Wǒ bù xǐhuān nàxiē yánsè. | Tôi không thích những màu kia.
长 | cháng | dài | 她的头发很长。| Tā de tóufa hěn cháng. | Tóc cô ấy rất dài.
短 | duǎn | ngắn | 这条裙子太短了。| Zhè tiáo qúnzi tài duǎn le. | Chiếc váy này quá ngắn.
高 | gāo | cao | 他个子很高。| Tā gèzi hěn gāo. | Anh ấy rất cao.
低 | dī | thấp | 今天温度很低。| Jīntiān wēndù hěn dī. | Hôm nay nhiệt độ rất thấp.
胖 | pàng | béo | 他最近有点胖了。| Tā zuìjìn yǒudiǎn pàng le. | Gần đây anh ấy hơi béo lên.
瘦 | shòu | gầy | 她太瘦了。| Tā tài shòu le. | Cô ấy quá gầy.
贵 | guì | đắt | 这件衣服太贵了。| Zhè jiàn yīfu tài guì le. | Cái áo này quá đắt.
甜 | tián | ngọt | 这个蛋糕很甜。| Zhège dàngāo hěn tián. | Cái bánh này rất ngọt.
酸 | suān | chua | 柠檬很酸。| Níngméng hěn suān. | Chanh rất chua.
重 | zhòng | nặng | 这本书很重。| Zhè běn shū hěn zhòng. | Cuốn sách này rất nặng.
轻 | qīng | nhẹ | 这个箱子很轻。| Zhège xiāngzi hěn qīng. | Cái vali này rất nhẹ.
远 | yuǎn | xa | 我家离学校很远。| Wǒ jiā lí xuéxiào hěn yuǎn. | Nhà tôi cách trường rất xa.
近 | jìn | gần | 医院离这儿很近。| Yīyuàn lí zhèr hěn jìn. | Bệnh viện rất gần chỗ này.
深 | shēn | sâu / đậm | 水很深，小心点。| Shuǐ hěn shēn, xiǎoxīn diǎn. | Nước rất sâu, cẩn thận nhé.
浅 | qiǎn | nông / nhạt | 这个颜色太浅了。| Zhège yánsè tài qiǎn le. | Màu này quá nhạt.
饱 | bǎo | no | 我吃饱了。| Wǒ chī bǎo le. | Tôi ăn no rồi.
渴 | kě | khát | 我很渴，想喝水。| Wǒ hěn kě, xiǎng hē shuǐ. | Tôi rất khát, muốn uống nước.